1 0 310 640 310
4 0 310 150 310 300 210 450 310 640 310
5 0 310 50 310 200 200 400 200 590 310 640 310
7 0 400 90 400 180 150 270 200 360 150 450 275 540 225 640 225
2 0 100 320 475 640 370
7 0 100 100 100 150 300 250 300 350 250 450 400 550 300 640 300
7 0 240 31 240 100 60 200 200 275 200 400 50 500 300 640 300
7 0 100 100 100 300 65 450 300 532 245 576 375 600 50 640 50
3 0 100 50 100 600 400 640 400
3 0 155 155 155 355 355 640 355
7 0 100 45 100 150 200 250 90 400 350 475 200 550 175 640 175
9 0 100 75 100 250 450 400 200 440 300 500 250 550 100 600 425 610 175 640 175
21 0 210 90 210 148 160 194 158 198 90 230 90 236 214 288 216 292 168 306 168 318 278 380 278 390 294 416 306 446 306 466 296 480 282 528 284 560 188 578 188 594 286 640 286 
27 0 188 64 188 64 266 118 266 134 256 146 232 146 204 174 204 176 254 216 304 326 304 326 200 374 200 374 116 422 116 422 316 494 292 494 236 506 236 512 252 530 262 552 262 566 252 568 290 580 308 600 322 618 322 640 312 
21 0 64 42 64 42 154 110 154 110 230 180 230 180 306 272 306 272 136 360 136 360 314 472 314 472 344 548 344 548 224 570 224 570 288 584 288 584 264 598 264 598 286 640 286
46 0 192 48 192 74 276 74 292 116 292 134 284 152 268 152 254 152 186 188 186 196 194 210 196 210 204 224 204 232 198 240 196 270 280 276 282 296 326 320 292 320 254 342 244 352 208 364 192 378 192 394 220 404 238 412 238 418 222 422 202 430 192 442 234 450 254 458 262 458 222 466 220 468 278 478 298 496 310 506 314 518 304 522 274 528 242 540 230 564 282 588 290 640 290
6 0 120 238 120 334 212 422 212 500 136 572 218 640 218
1 0 126 640 126
5 0 96 104 96 134 140 134 234 560 234 640 234
1 0 130 640 130
12 0 102 0 102 62 102 370 226 355 234 0 9088 355 9088 355 3537 0 9088 355 9088 355 3537 0 9088 395 38144
1 0 126 640 126
15 0 138 0 138 130 138 130 190 170 190 170 236 318 236 392 198 452 200 470 262 524 280 502 216 444 172 444 146 528 146 640 214